###Irregular_Verbs###
awake	awake	awaken
blow	blew	blown
build	built	built
buy	bought	bought
catch	caught	caught
choose	chose	chosen
dream	dreamt	dreamt
drink	drank	drunk
eat	ate	eaten
fall	fell	fallen
fight	fought	fought
fly	flew	flawn
freeze	froze	frozen
grow	grew	grown
hear	heard	heard
hide	hid	hidden
hold	held	held
know	knew	known
lay	laid	laid
leave	left	left
lend	lent	lent
lose	lost	lost
pay	paid	paid
quit	quit	quit
read	read	read
ride	rode	ridden
run	ran	run
say	said	said
seek	sought	sought
sell	sold	sold
send	sent	sent
shake	shook	shaken
shine	shone	shone
sing	sang	sung
sink	sank	sunk
sit	sat	sat
sleep	slept	slept
spend	spent	spent
spread	spread	spread
stand	stood	stood
steal	stole	stolen
swear	swore	sworn
swim	swam	swum
teach	taught	taught
tell	told	told
think	thought	thought
wear	wore	worn
win	won	won
write	wrote	written
be/am/are	was/were	been
arise	arose	arisen
bear	bore	born
beat	beat	beaten
begin	began	begun
bend	bent	bent
bet	bet	bet
bid	bid	bid
bite	bit	bit
bring	brought	brought
burn	burnt	burnt
come	came	come
cost	cost	cost
cut	cut	cut
deal	dealt	dealt
dig	dug	dug
dive	dove	dived
do	did	done
draw	drew	drawn
drive	drove	driven
feel	felt	felt
find	found	found
forget	forgot	forgotten
forgive	forgave	forgiven
get	got	gotten
give	gave	given
go	went	gone
hang	hung	hung
have	had	had
hit	hit	hit
hurt	hurt	hurt
keep	kept	kept
lead	led	led
let	let	let
lie	lay	lain
make	made	made
mean	meant	meant
meet	met	met
put	put	put
ring	rang	rung
rise	rose	risen
see	saw	seen
shoot	shot	shot
show	showed	shown
shrink	shrank	shrunk
shut	shut	shut
speak	spoke	spoken
take	took	taken
tame	tamed	tamed
tear	tore	torn
throw	threw	trown
understand	understood	understood
wake	woke	woken
weave	wove	woven
weep	wept	wept
become	became	become
break	broke	broken
ttt	ttt	ttt